======================================================================================.
S |         |     | |           |               |   |                   |   |         |
| | ======= | ==. | | .===. .===' .=. ====. .===| | | .===. .========== | | | | ======|
| |   |     |   |   | |   | |     | |     | |   | |   |   | |     |     | |   |       |
| '=. '===. '=. '===| | | | | .===' |==== |=' | | |===' | | |===. | .===' |========== |
|   |     |   |     | | |   | |     |     |   |   |     |   |   |   |     |           |
|=. |===. '=. '==== | | '===| | ====| | .=' .=====' .===| .=' | '===' .===' .======== |
| | |   |   |       | |     | |     | | |   |       |   | |   |   |   |     |         |
| | | | |== |=====. | '==== | | .== | '=| ==| ========. | | ==+=. | ==| ==============|
| |   | |   |     | |   |   | | |   |   |   |     |   |   |   | |     |         |     |
| '===| | ==| ==. '==== | ==| '=| ====. | .====== | | '=. '=. | |=========. ==. | ==. |
|     | |   |   |       |   |   |     |   |       | |   |   |   |         |   |     | |
| ==. | '=. '== |===. .==== '=. | ==. '===| ======' |== |===' .=' .====== |== '=====| |
|   | |   |     |   | |       | |   |     |   |     |   |     |   | |     |     |   | |
|== | '=. '=====' | | | ======' '===' .====== | .===| ==' .===' .=' | ========. | | | |
|   |   |   |     | | |   |           |       | |   |     |     |             | | | | |
| .===. '=. | .===| | |=. | .=======. | .===. | |== |=====| ================= '=' | | |
| |   |   |   |   | | | |   |   |   | | |   | | |   | |   |   |         |         | | |
| '== | ==+===' ==' | | '===' | '=. | | | | '=| | | | | | '== | .====== | .=======| | |
|     |   |         |     |   |   |   | | |   |   |   | |     | |   |   | |   |   |   |
|=======. | ========' .===' .===. '===| | '=. '=====. | '===. | | | | ====' | | | '===|
|   |   | |     | |   |     |   |     |     |       | |   | | |   | |       |   |     |
| | | | | '===. | | ==| .===' .=====. | ======= .===| '=. | | |===' |================ |
| |   |       | |     | |     |     | |   |     |   |   | |   |     |                 |
| |===+== .===| '=====' | ====' | ==' |== | .== | | '=. | '===| ====| .=========. .===|
| |   |   |   |     |   |       |     |   | |   | |   | |     |   | | |   |     | |   |
| '=. | .=' | |==== | .=============. | ==| '===' '=. | |===. '=. | | | | | ==. '=' | |
|   |   |   | |     | |   |         | |   |         |   |   |   | | | | | |   |     | |
| | '===' .=' | ====| | | | .====== | '=================' | '=. | | | | | '== '=====' |
| |   |   |   |   | |   |   |       |       |         |   |   |     | | |         |   |
| |== | .=| ====. | | .=====' .===========. | .====== | .===. | .===' | '=========' | |
| |   | | |     | |   |       |           |   |         |   | | |     |   |   |     | |
| | ==' | |==== | '=. | ======' ======. | |===' .=======' ==' | | ======= | | | .===| |
| |       |     |   | |           |   | | |     |   |         | |           | | |   | |
| |=======' .====== |=============| | | | | .===' | '=====. ====| ==========+=' | | | |
| |         |       |             | | | | | |     |       |     |   |       |   | | | |
| | .== .===' .=====' ==========. | | | | '=' .=========. '===. '===' .==== | ==' | '=|
| | |   |     |   |       |     |   | | |     |     |   |     |       | |   |     |   |
| | '===' ====' | '====== | ========' '=======' .== | | '==== |=======' | =========== |
| |             |         |                     |     |       |                       E
'======================================================================================