============================================================.
S   |   |     |                   |       |   |             |
.=. | ==' | .=' .====== .=======. | .===. '== | ========. | |
| | |     | |   |       |   |   |   |   |     |   |     | | |
| | '=====| | ==| ========. | | | .=' | |=====' .=' .== '=' |
| |   |   |     |     |   |   |   |   | |       |   |       |
| '=. | | '========== | | '=======| ==| | .=====| ==========|
|   | | |     |       | |         |   |   |     |           |
|== | | '===. | .=====' |======== '=. '===' .============== |
|   | |     |   |       |   |       |       |               |
| ==| '===. '===' ========= | ==. .=' .=====' .=============|
|   |     |   |             |   | |   |       |   |         |
| | '===. '=. | .============== |=' .=' | .===' | | .====== |
| |     |   |   |               |   |   | |     |   |       |
| |==== '=. |===| .===========. | .=| ==| | .=======| ======|
| |       | |   | |           | | | |   | | |       |       |
|=' .===. | | | | | ========. |=' | '=. '=| | .===. '====== |
|   |   | |   | |       |   | |   |   |   | | |   |         |
| ==' | '=====| | .=====' | | | ==| | '=. | | | ==' .=======|
|     |       | | |       | | |   | |   |   | |     |       |
| =========== | | | .=====' | |== |=' | '===| '===. | ====. |
|   |         | | | |         |   |   |     |     | |     | |
|=. | ====. .=' | | '=========| .=' ========+==== | | .===' |
| | |     | |   | |           | |           |     | | |     |
| | '==== | | .===========. | | |========== | | .===' | ====|
|     |   | | |           | | | |   |       | | |     |     |
|=====' .===| | ========. | | | | | | .=====| '=' .===| ==. |
|       |   | |         | | |     |   |     |     |   |   | |
| ======' | | '======== | '===========' .== '=====' | '===' |
|         |             |               |           |       E
'============================================================