==================================================.
S |           |     |               |   |     |   |
| '=. ========' | ==| | ==========. | .=' | | | | |
|   |           |   | |   |       | | |   | |   | |
|=. | ============. | '=. |=====. | | | .=| '===' |
| | |         |   |     | |     |   | | | |   |   |
| | | .====== | .=======| | .== | ==' | | |=. '===|
|   | |   |     |       | | |   |     |   | |     |
| ====' | '=. .=' .==== | | | ======. |== | '==== |
|       |   | |   |       | |       | |   |   |   |
|=========. '=| ======. .=' '=====. '=| .=' ==| | |
|         |   |       | |     |   |   | |     | | |
| .=========. '=====. |=' .===' | '=. | | .== | | |
| |         |   |   | |   | |   |   | | | |   | | |
| | .==== .===. | | | | ==' | ==+== | | |=' .=' | |
|   |     |   | | | | |     |   |     | |   |   | |
| .=' .===' | | | | | |== .===. '=====' | ==| ====|
| |   |     | |   | | |   |   |     |   |   |     |
| | ==' .===' |===| | | .=' | '=. | | .==== '==== |
| |     |     |   | |   |   |   | | | |       |   |
| '=====' .== | | | '=. | ==+== | | | | .==== | ==|
|     |   |   | | |   | |   |   | | |   |     |   |
|==== | ==| .=' | '=. '===. '=. '=| '===' ======. |
|     |   | |   |   |     |   |   |         |   | |
|======== | | ==+== '===. '== |=. '=========' | | |
|         | |   |       |     | |     |       | | |
| | .=====' | .=' .===. '=====' '==== | ======' | |
| | |   |   | |   |   |   |       |   |     |   | |
| '=' | '===' | ==' | '===' ==. ==' ======= | ==' |
|     |       |     |         |             |     E
'==================================================