====================.
S |         |   |   |
| '=======. | | | | |
|         |   |   | |
|=======. '===+===' |
|       |     |     |
| .== .=====. | .=. |
| |   |     |   | | |
| '===' ==. '===' | |
|         |         E
'====================