==============================.
S   | |                 |     |
.== | | .=====. .=====. '==== |
|   |   |     | | |   |   |   |
| .=====' .=. | | | | |== | ==|
| |       | |   |   | |   |   |
| | ======' '===| ==| | .=' | |
| |     |       |   | | |   | |
| '==== | | ======= | | '===' |
|       | |         |         E
'==============================