======================================================================.
S       |       |               |                   |       |         |
.====== | | ==. | .==== .===. .=' | .=============. '=. | ==' .==== | |
|   |   | |   | | |     |   | |   | |             |   | |     |     | |
| .=' .=====. | | | .===' | '=' .=| | .========== |== '=======| .===| |
| |   |     | | | | |     |     | | | | |     |   |       |   | |   | |
| | ==| ==. | | | | | ========. | | | | | ==. | .=======. | | | | | '=|
| |   |   |   | | |     |     |   |     |   |   |   |   | | | |   |   |
| '=. '=. '===| '=======' .== | .========== |===' | | | | | | |====== |
|   |   |     |           |   | |           |     | | |     | |       |
|== '=. |==== |===========| .===' .====== .=' .===| '=+=====| | ======|
|     | |     |   |       | |     | |     |   |   |   |     | |   |   |
| .===' | ====' ==' | ====' |== .=' | ====' .=' | '== | ==. | '=. | | |
| |     |   |       |   |   |   |   |   |   |   |     |   | |   |   | |
| | ====' | |=========. | .=' .==== |== | .=| ======. | .=' |== '===| |
| |   |   | |     |   |   |   |     |   | | |       | | |   |       | |
| '=. | ==| | .=. | | | .=' | '=. ==' .=' | |====== |=' | ========. | |
|   | |   | | | | | | | |   |   |     |   | |       |   |         |   |
|== | | .=' | | | | | | '=====. |=====| .=' | ======' .========== |== |
|   | | |   | | | | | |       | |     | |   |         |           |   |
| .=' | | | | | | | | |=====. | | .=. | '== '=========| ==============|
| |   | | | |   |   | |     | |   | | |         |     |     |   |     |
| | .===' | '=. |===| | .== | '=. | | | .=======' .=. '=. | | | | ==. |
| | |     |   | |   | | |   |   |   | | |         | |   | | | |     | |
| | | .== |===' | | | | | ==+== '===| | | ========' '=. '=| | '=====' |
| | | |   |     | | |   |   |       |   |     |       |   | |   |     |
| | | '===' ====| | '=. '=. '=====. |======== |== .=====. | | .=' .===|
| | |           | |   |   |   |   | |         |   |     | |   |   |   |
| | '===========' |=. '===| | '=. | | .=======' .=' ==. | '===| ==' | |
| |   |           | |     | |   |     |         |     | |     |     | |
| |== | .== .=====| '==== '=| | '=====| .==== .=' .===' '===. | .===' |
| |   | |   |     |         | |     | | |     |   |         | | |     |
| | .=' '=. | .== | .====== '=+==== | | | ====| .=' .====== | '=' .== |
|   |     | | |   | |   |     |     |   |     | |   |       |     |   |
| .====== | | | .===' | '===. | .=====. |==== | | ====. ==========' .=|
| |   |   | | | |     |     |   |     | |     | |     |   |     |   | |
| | | | ====' | | .===| .== |===| ==. '=' .== | |==== |===' .== | .=' |
|   | |       |   |   | |   |   |   |     |   | |     |     |   | |   |
|===' '===========' | '=' .=' ==' | '=========' | ====' ====| ==' '== |
|                   |     |       |             |           |         E
'======================================================================